198 21
######################################################################################################################################################################################################
#........................................................#####.......................................................................................................................................#
#........................................................####........................................................................................................................................#
#........................................................####........................................................................................................................................#
#.........................................................###.....................................................................################################...................................#
#.........................................................###.....................................................................################################...................................#
#.........................................................##.....................................................................################################....................................#
#.........................................................##.....................................................................################################....................................#
#.........................................................#..........................................................................################################................................#
#...................................................................................................................................################################.................................#
#...................................................................................................................................################################.................................#
#....................................................................................................................................................................................................#
#....................................................................................................................................................................................................#
#....................................................................................................................................................................................................#
#....................................................................................................................................................................................................#
#.................................................................############################################.......................................................................................#
#..............................................................###############################################.......................................................................................#
#..........................################....................###############################################.......................................................................................#
#..........................################..................#################################################.......................................................................................#
#..........................################..................#################################################.......................................................................................#
######################################################################################################################################################################################################